00000000000000000000000001
00000000000000000000000001
00000000000000000000000001
00000000000000000000000001
00000000000000000000000001
00000000000000000000000001
00000000000000000000000001
00000000000000000000000001
11111111111111111100000001
11111111111111111111000001
11111111111111111111000001
11111111111111111111000001
11110000000000000000000001
11110000000000000000000001
11110000000000000000000001
11110000000000000000000001
11110000000000000000000001
11110000000000000000000001
11110000000000000000000001
11110000000000000000000001
11111111111111111111111111
